question_id,label,response,difficulty,input_tokens,output_tokens,total_tokens,correct
sample_1,E,E,basic,6885,5539,12424,1
sample_2,E,E,basic,6820,5399,12219,1
sample_3,B,B,basic,6701,5080,11781,1
sample_4,D,D,basic,7515,6229,13744,1
sample_5,C,C,basic,6369,4728,11097,1
sample_6,A,A,basic,7510,6200,13710,1
sample_7,E,E,basic,7682,5306,12988,1
sample_8,B,B,basic,6990,5572,12562,1
sample_9,E,E,basic,7401,5816,13217,1
sample_10,D,D,basic,7803,6226,14029,1
sample_11,E,D,intermediate,73828,7522,81350,0
sample_12,E,C,basic,7544,5981,13525,0
sample_13,D,D,advanced,25851,17213,43064,1
sample_14,E,B,basic,9099,7083,16182,0
sample_15,E,E,basic,7043,71403,78446,1
sample_16,E,E,basic,7130,5292,12422,1
sample_17,A,A,intermediate,26730,6342,33072,1
sample_18,D,A,basic,7272,5393,12665,0
sample_19,E,C,advanced,26323,17384,43707,0
sample_20,A,A,intermediate,27366,6879,34245,1
sample_21,E,E,basic,6803,5549,12352,1
sample_22,E,E,basic,9328,6945,16273,1
sample_23,A,A,basic,6640,5025,11665,1
sample_24,C,C,basic,7148,5954,13102,1
sample_25,C,C,basic,7760,6009,13769,1
sample_26,D,D,basic,8710,6962,15672,1
sample_27,E,E,basic,8480,7435,15915,1
sample_28,A,A,intermediate,34507,7647,42154,1
sample_29,D,D,basic,6549,5306,11855,1
sample_30,D,D,intermediate,26961,6534,33495,1
sample_31,B,B,basic,6635,5175,11810,1
sample_32,B,B,basic,8041,6250,14291,1
sample_33,C,C,basic,6372,5277,11649,1
sample_34,D,D,basic,6345,4714,11059,1
sample_35,A,A,basic,6500,5183,11683,1
sample_36,D,A,basic,10350,8198,18548,0
sample_37,C,C,basic,6869,5175,12044,1
sample_38,B,D,basic,7078,5385,12463,0
sample_39,C,C,basic,7636,5338,12974,1
sample_40,A,A,basic,6205,4753,10958,1
sample_41,B,B,basic,7880,6718,14598,1
sample_42,C,C,basic,6348,4839,11187,1
sample_43,C,C,advanced,29743,21187,50930,1
sample_44,D,D,basic,8087,5131,13218,1
sample_45,B,,basic,8151,6423,14574,0
sample_46,D,D,basic,6495,4969,11464,1
sample_47,B,B,basic,8087,6646,14733,1
sample_48,C,C,basic,6828,5459,12287,1
sample_49,C,C,basic,6704,5223,11927,1
sample_50,A,A,basic,5250,3927,9177,1
sample_51,D,D,intermediate,32184,7138,39322,1
sample_52,D,C,intermediate,53476,7108,60584,0
sample_53,E,E,basic,6577,5285,11862,1
sample_54,B,B,basic,7747,5711,13458,1
sample_55,E,E,basic,6935,5147,12082,1
sample_56,B,B,basic,5908,4708,10616,1
sample_57,A,A,basic,6862,5105,11967,1
sample_58,D,D,basic,7219,5598,12817,1
sample_59,B,B,intermediate,35255,7383,42638,1
sample_60,C,C,basic,6857,5241,12098,1
sample_61,C,C,basic,7768,5853,13621,1
sample_62,A,A,basic,7629,6160,13789,1
sample_63,B,B,basic,6033,4630,10663,1
sample_64,D,D,intermediate,30679,6520,37199,1
sample_65,E,A,basic,8142,6170,14312,0
sample_66,E,E,basic,5901,4710,10611,1
sample_67,A,A,basic,9432,7786,17218,1
sample_68,A,A,basic,8011,6207,14218,1
sample_69,D,D,basic,6514,4425,10939,1
sample_70,E,E,intermediate,26452,5543,31995,1
sample_71,A,A,advanced,24145,17593,41738,1
sample_72,D,A,basic,7998,6167,14165,0
sample_73,A,A,basic,5810,3772,9582,1
sample_74,B,B,intermediate,213609,11349,224958,1
sample_75,B,B,basic,5679,4021,9700,1
sample_76,D,D,basic,5487,3998,9485,1
sample_77,A,A,basic,9006,7551,16557,1
sample_78,E,E,basic,6617,5005,11622,1
sample_79,E,E,basic,7959,6285,14244,1
sample_80,E,E,basic,5809,4804,10613,1
sample_81,C,,basic,6540,5087,11627,0
sample_82,B,B,basic,6347,5095,11442,1
sample_83,C,C,intermediate,62881,7123,70004,1
sample_84,E,E,basic,6623,4804,11427,1
sample_85,C,C,basic,6753,5413,12166,1
sample_86,C,C,basic,7628,5939,13567,1
sample_87,A,D,basic,7006,5795,12801,0
sample_88,D,D,basic,7127,5757,12884,1
sample_89,B,B,advanced,29724,19052,48776,1
sample_90,B,B,basic,7272,5772,13044,1
sample_91,D,C,basic,9583,7719,17302,0
sample_92,C,C,basic,8104,6967,15071,1
sample_93,D,D,basic,6525,5122,11647,1
sample_94,A,,basic,7591,5983,13574,0
sample_95,B,B,basic,6581,5201,11782,1
sample_96,A,A,basic,4888,3418,8306,1
sample_97,C,C,intermediate,26368,6790,33158,1
sample_98,E,A,basic,8733,6665,15398,0
sample_99,B,B,intermediate,244400,10162,254562,1
sample_100,D,D,intermediate,79299,7968,87267,1
sample_101,E,E,basic,5706,4447,10153,1
sample_102,A,C,basic,7973,6510,14483,0
sample_103,A,A,basic,7127,5339,12466,1
sample_104,C,C,basic,8145,6576,14721,1
sample_105,C,C,basic,7205,6137,13342,1
sample_106,D,D,advanced,28233,18247,46480,1
sample_107,C,C,basic,5954,4434,10388,1
sample_108,A,A,basic,8233,6585,14818,1
sample_109,B,B,basic,6081,4875,10956,1
sample_110,B,B,basic,5997,4430,10427,1
sample_111,A,A,basic,6869,5548,12417,1
sample_112,E,E,advanced,27442,17750,45192,1
sample_113,E,E,basic,7089,6222,13311,1
sample_114,D,A,intermediate,37751,7052,44803,0
sample_115,B,B,basic,7670,5809,13479,1
sample_116,B,B,intermediate,25279,6090,31369,1
sample_117,D,E,basic,8012,6527,14539,0
sample_118,D,D,basic,7251,5489,12740,1
sample_119,C,C,basic,7551,6154,13705,1
sample_120,C,C,basic,7494,5936,13430,1
sample_121,E,E,basic,7088,6040,13128,1
sample_122,E,E,basic,7525,5652,13177,1
sample_123,B,D,basic,8137,5665,13802,0
sample_124,A,A,basic,6841,5257,12098,1
sample_125,A,A,basic,6179,4186,10365,1
sample_126,D,D,basic,6470,5202,11672,1
sample_127,A,A,basic,8119,6679,14798,1
sample_128,D,D,basic,5363,3996,9359,1
sample_129,B,B,basic,7290,5498,12788,1
sample_130,D,D,basic,9109,7569,16678,1
sample_131,A,A,basic,7211,5173,12384,1
sample_132,A,A,basic,10303,9084,19387,1
sample_133,B,B,basic,6584,5306,11890,1
sample_134,A,A,basic,6733,5246,11979,1
sample_135,D,D,basic,9736,7692,17428,1
sample_136,B,B,basic,6515,5368,11883,1
sample_137,D,A,basic,5710,69715,75425,0
sample_138,D,D,basic,7304,71515,78819,1
sample_139,B,B,intermediate,25523,7110,32633,1
sample_140,C,C,basic,7559,6378,13937,1
sample_141,D,D,basic,8649,6155,14804,1
sample_142,B,A,basic,5787,4359,10146,0
sample_143,B,B,basic,7318,5107,12425,1
sample_144,A,A,basic,6746,5168,11914,1
sample_145,B,,basic,8121,6813,14934,0
sample_146,C,C,basic,7149,5513,12662,1
sample_147,B,B,basic,8886,6915,15801,1
sample_148,B,B,basic,6823,5697,12520,1
sample_149,A,A,basic,6889,5204,12093,1
sample_150,B,B,basic,8420,6827,15247,1
sample_151,A,D,intermediate,32675,7125,39800,0
sample_152,C,A,basic,9813,8138,17951,0
sample_153,C,C,basic,7498,6148,13646,1
sample_154,A,A,intermediate,26218,5524,31742,1
sample_155,D,B,intermediate,25524,5534,31058,0
sample_156,A,A,basic,7329,4617,11946,1
sample_157,D,D,basic,8044,6245,14289,1
sample_158,A,A,basic,6559,70109,76668,1
sample_159,A,A,basic,7131,5480,12611,1
sample_160,B,D,basic,8516,6833,15349,0
sample_161,D,D,basic,6553,5340,11893,1
sample_162,D,D,basic,5002,3346,8348,1
sample_163,A,B,intermediate,130679,8921,139600,0
sample_164,E,E,basic,6371,5011,11382,1
sample_165,E,E,basic,6970,4993,11963,1
sample_166,D,D,basic,9443,6399,15842,1
sample_167,C,A,advanced,27010,17505,44515,0
sample_168,C,C,basic,6734,5068,11802,1
sample_169,E,E,basic,6695,5016,11711,1
sample_170,C,C,intermediate,34911,7792,42703,1
sample_171,D,D,basic,6293,4827,11120,1
sample_172,A,A,basic,7239,5029,12268,1
sample_173,C,C,basic,9000,6623,15623,1
sample_174,A,A,basic,7974,6230,14204,1
sample_175,C,C,intermediate,32747,7634,40381,1
sample_176,B,A,basic,8624,72186,80810,0
sample_177,C,A,basic,6963,5623,12586,0
sample_178,A,A,basic,7137,5706,12843,1
sample_179,A,A,basic,7230,5327,12557,1
sample_180,C,C,basic,5995,4726,10721,1
sample_181,A,A,basic,7650,4869,12519,1
sample_182,C,C,basic,7529,5914,13443,1
sample_183,C,C,basic,7485,5858,13343,1
sample_184,E,E,basic,6403,4516,10919,1
sample_185,D,A,basic,8308,6649,14957,0
sample_186,B,B,basic,6567,5190,11757,1
sample_187,C,C,basic,7923,6452,14375,1
sample_188,B,B,basic,8380,7105,15485,1
sample_189,D,D,basic,7405,5509,12914,1
sample_190,C,C,basic,6493,4421,10914,1
sample_191,C,C,basic,7465,5855,13320,1
sample_192,A,A,basic,6887,5626,12513,1
sample_193,A,A,basic,8360,71874,80234,1
sample_194,E,E,basic,6256,4478,10734,1
sample_195,C,C,basic,7156,5530,12686,1
sample_196,A,A,intermediate,63440,6723,70163,1
sample_197,B,B,basic,5790,4434,10224,1
sample_198,E,E,basic,7198,5710,12908,1
sample_199,E,D,basic,7179,5441,12620,0
sample_200,D,D,basic,8781,7081,15862,1
sample_201,E,E,advanced,29156,17874,47030,1
sample_202,A,A,intermediate,31774,6614,38388,1
sample_203,C,C,basic,8329,5823,14152,1
sample_204,D,D,intermediate,25323,5741,31064,1
sample_205,A,A,basic,7894,6029,13923,1
sample_206,A,A,basic,8007,6208,14215,1
sample_207,D,D,basic,7378,6046,13424,1
sample_208,D,D,basic,6596,4818,11414,1
sample_209,D,D,basic,6698,5115,11813,1
sample_210,B,E,intermediate,26886,5780,32666,0
sample_211,C,C,basic,5896,4867,10763,1
sample_212,A,A,basic,8667,7447,16114,1
sample_213,C,C,basic,7309,5940,13249,1
sample_214,D,D,basic,6285,4823,11108,1
sample_215,E,B,basic,7868,6133,14001,0
sample_216,C,D,advanced,22666,14206,36872,0
sample_217,D,D,basic,8720,7058,15778,1
sample_218,A,A,intermediate,26349,5699,32048,1
sample_219,D,D,basic,10704,9152,19856,1
sample_220,A,A,basic,7772,5848,13620,1
sample_221,D,D,basic,8829,6650,15479,1
sample_222,A,A,basic,8244,6610,14854,1
sample_223,A,B,basic,6354,4737,11091,0
sample_224,A,A,basic,8699,6401,15100,1
sample_225,B,C,basic,7849,6223,14072,0
sample_226,B,B,basic,7147,5731,12878,1
sample_227,B,B,basic,7196,5823,13019,1
sample_228,A,A,advanced,25590,18882,44472,1
sample_229,A,A,basic,7165,5187,12352,1
sample_230,B,A,basic,6678,4942,11620,0
sample_231,E,E,basic,6611,4665,11276,1
sample_232,B,B,intermediate,34830,8594,43424,1
sample_233,B,B,basic,6557,4947,11504,1
sample_234,E,E,basic,7323,6064,13387,1
sample_235,C,C,basic,7265,5256,12521,1
sample_236,B,B,basic,4994,3450,8444,1
sample_237,D,D,basic,11550,5330,16880,1
sample_238,E,E,intermediate,32968,6324,39292,1
sample_239,A,A,basic,6736,5113,11849,1
sample_240,A,A,basic,7922,5706,13628,1
sample_241,C,C,basic,7171,5505,12676,1
sample_242,D,D,basic,6731,4920,11651,1
sample_243,B,B,intermediate,26763,6064,32827,1
sample_244,A,A,basic,8261,7062,15323,1
sample_245,B,B,basic,6730,5343,12073,1
sample_246,A,A,basic,7410,5643,13053,1
sample_247,C,C,advanced,24544,15846,40390,1
sample_248,B,B,basic,5729,4645,10374,1
sample_249,B,B,basic,6319,4812,11131,1
sample_250,B,B,intermediate,28865,4935,33800,1
sample_251,A,A,basic,7140,5316,12456,1
sample_252,C,C,basic,5485,4034,9519,1
sample_253,C,C,advanced,36704,24793,61497,1
sample_254,C,C,basic,8127,6912,15039,1
sample_255,C,B,basic,7496,6097,13593,0
sample_256,E,A,intermediate,28459,5668,34127,0
sample_257,B,B,basic,7073,4789,11862,1
sample_258,E,,basic,6466,4953,11419,0
sample_259,E,E,basic,6936,5202,12138,1
sample_260,B,D,basic,7366,6147,13513,0
sample_261,A,A,basic,7934,5877,13811,1
sample_262,E,E,intermediate,30399,6640,37039,1
sample_263,C,C,basic,6584,5231,11815,1
sample_264,B,B,basic,6389,5060,11449,1
sample_265,D,D,basic,5797,4367,10164,1
sample_266,B,B,intermediate,19592,5008,24600,1
sample_267,A,A,advanced,27674,17675,45349,1
sample_268,D,D,advanced,25455,16306,41761,1
sample_269,B,D,intermediate,76793,6992,83785,0
sample_270,D,A,advanced,26458,17094,43552,0
sample_271,D,D,intermediate,31439,7421,38860,1
sample_272,E,A,intermediate,29423,6088,35511,0
sample_273,C,C,advanced,28903,18693,47596,1
sample_274,B,B,basic,6939,5060,11999,1
sample_275,E,E,basic,7286,5296,12582,1
sample_276,A,A,intermediate,88085,9021,97106,1
sample_277,A,A,intermediate,22630,5148,27778,1
sample_278,D,D,intermediate,32943,6871,39814,1
sample_279,B,B,basic,7340,5052,12392,1
sample_280,A,A,intermediate,35235,7153,42388,1
sample_281,B,B,intermediate,104283,8538,112821,1
sample_282,C,C,intermediate,36670,6270,42940,1
sample_283,A,C,intermediate,36733,7349,44082,0
sample_284,A,A,basic,7087,4612,11699,1
sample_285,A,D,intermediate,27856,5955,33811,0
sample_286,A,A,advanced,35984,23369,59353,1
sample_287,B,B,advanced,24301,15286,39587,1
sample_288,B,D,intermediate,82191,9198,91389,0
sample_289,B,B,intermediate,34600,7686,42286,1
sample_290,D,D,intermediate,31305,6043,37348,1
sample_291,C,C,intermediate,26322,6291,32613,1
sample_292,C,C,basic,7494,5395,12889,1
sample_293,C,C,intermediate,32012,6871,38883,1
sample_294,E,E,advanced,35094,22690,57784,1
sample_295,A,A,intermediate,26061,6889,32950,1
sample_296,C,C,basic,8698,6631,15329,1
sample_297,B,B,intermediate,20289,4487,24776,1
sample_298,C,A,intermediate,28668,7337,36005,0
sample_299,E,E,advanced,26187,17445,43632,1
sample_300,C,C,basic,9318,7062,16380,1
sample_301,D,D,intermediate,31328,6547,37875,1
sample_302,D,B,advanced,37080,24220,61300,0
sample_303,E,B,advanced,28109,19342,47451,0
sample_304,D,D,advanced,33203,21182,54385,1
sample_305,E,E,intermediate,27294,5560,32854,1
sample_306,B,E,basic,6885,5432,12317,0
sample_307,B,B,basic,12276,10614,22890,1
sample_308,D,D,advanced,21967,14334,36301,1
sample_309,D,D,advanced,27517,17534,45051,1
sample_310,C,C,advanced,25776,16839,42615,1
sample_311,B,D,basic,7553,6499,14052,0
sample_312,C,C,advanced,25745,15763,41508,1
sample_313,D,D,intermediate,201117,12968,214085,1
sample_314,A,A,advanced,20669,12716,33385,1
sample_315,D,A,advanced,32923,21276,54199,0
sample_316,A,A,advanced,30461,19347,49808,1
sample_317,B,B,advanced,29776,21769,51545,1
sample_318,B,B,intermediate,28432,7890,36322,1
sample_319,E,E,advanced,24508,14588,39096,1
sample_320,A,C,advanced,30470,19169,49639,0
sample_321,B,D,advanced,31770,18848,50618,0
sample_322,D,D,advanced,25689,15997,41686,1
sample_323,E,E,advanced,34904,23346,58250,1
sample_324,A,A,advanced,29823,19159,48982,1
sample_325,A,A,advanced,24369,16200,40569,1
sample_326,B,A,advanced,33318,21342,54660,0
sample_327,B,A,advanced,34771,22008,56779,0
sample_328,D,D,advanced,26859,18333,45192,1
sample_329,E,E,advanced,30146,19227,49373,1
sample_330,A,A,advanced,29103,18820,47923,1
sample_331,B,D,advanced,31155,19309,50464,0
sample_332,B,B,intermediate,29602,6830,36432,1
