question_id,label,response,difficulty,input_tokens,output_tokens,total_tokens,correct
sample_1,C,B,basic,8249,6834,15083,0
sample_2,E,E,basic,8412,7791,16203,1
sample_3,C,C,basic,10135,8505,18640,1
sample_4,D,D,advanced,14084,8190,22274,1
sample_5,B,B,basic,8222,7072,15294,1
sample_6,E,C,basic,10453,9543,19996,0
sample_7,D,D,basic,6280,5432,11712,1
sample_8,C,C,basic,9794,8492,18286,1
sample_9,C,C,basic,6114,4883,10997,1
sample_10,A,A,basic,6943,5987,12930,1
sample_11,E,E,basic,8610,6811,15421,1
sample_12,D,D,advanced,19722,11858,31580,1
sample_13,B,B,intermediate,27618,6870,34488,1
sample_14,E,E,basic,7849,6710,14559,1
sample_15,D,D,basic,6783,5697,12480,1
sample_16,B,B,advanced,18459,11157,29616,1
sample_17,E,E,basic,9047,7693,16740,1
sample_18,E,E,basic,8178,6482,14660,1
sample_19,B,B,basic,7124,5743,12867,1
sample_20,E,C,basic,5985,4688,10673,0
sample_21,C,E,advanced,16248,10655,26903,0
sample_22,A,D,basic,6187,5305,11492,0
sample_23,D,E,basic,9459,8588,18047,0
sample_24,E,B,basic,8321,7298,15619,0
sample_25,A,A,basic,8361,6343,14704,1
sample_26,E,E,basic,8353,15905,24258,1
sample_27,E,E,basic,7056,5429,12485,1
sample_28,A,A,basic,6494,5141,11635,1
sample_29,D,D,basic,7591,5885,13476,1
sample_30,D,A,basic,8972,7981,16953,0
sample_31,E,E,basic,7630,6960,14590,1
sample_32,C,D,basic,9770,8814,18584,0
sample_33,E,E,advanced,17903,9979,27882,1
sample_34,B,E,advanced,16419,10594,27013,0
sample_35,B,B,advanced,20399,12271,32670,1
sample_36,A,A,basic,6265,5827,12092,1
sample_37,E,E,basic,7095,7129,14224,1
sample_38,A,A,basic,6999,6216,13215,1
sample_39,E,E,basic,11550,9485,21035,1
sample_40,A,A,basic,7366,6214,13580,1
sample_41,D,D,advanced,13964,8012,21976,1
sample_42,C,C,basic,10173,7780,17953,1
sample_43,A,A,basic,8493,6784,15277,1
sample_44,C,C,basic,7613,6933,14546,1
sample_45,B,D,advanced,17182,9934,27116,0
sample_46,E,A,advanced,16542,11110,27652,0
sample_47,C,C,basic,7827,6457,14284,1
sample_48,A,A,basic,7899,6648,14547,1
sample_49,B,B,basic,7144,6253,13397,1
sample_50,D,D,basic,6541,5462,12003,1
sample_51,E,E,basic,9080,8102,17182,1
sample_52,A,A,basic,8017,6603,14620,1
sample_53,D,D,basic,4947,3958,8905,1
sample_54,D,D,basic,6488,6071,12559,1
sample_55,B,B,basic,7644,6757,14401,1
sample_56,B,B,basic,5579,4467,10046,1
sample_57,C,C,basic,7231,6596,13827,1
sample_58,B,B,advanced,13455,9510,22965,1
sample_59,C,C,intermediate,38160,7618,45778,1
sample_60,A,C,basic,9189,8041,17230,0
sample_61,D,D,intermediate,26714,7278,33992,1
sample_62,A,A,basic,7314,6203,13517,1
sample_63,D,B,basic,6302,6662,12964,0
sample_64,A,A,basic,8278,7296,15574,1
sample_65,A,C,basic,7074,5609,12683,0
sample_66,C,C,basic,6417,5727,12144,1
sample_67,D,D,basic,6914,5576,12490,1
sample_68,C,C,advanced,19235,11460,30695,1
sample_69,D,D,advanced,19120,12336,31456,1
sample_70,A,B,basic,7329,5990,13319,0
sample_71,A,A,basic,7518,6241,13759,1
sample_72,A,A,basic,5999,4639,10638,1
sample_73,C,C,advanced,21331,12145,33476,1
sample_74,B,B,basic,6418,5570,11988,1
sample_75,C,A,basic,7695,5886,13581,0
sample_76,A,A,basic,6707,5543,12250,1
sample_77,B,B,basic,7142,6045,13187,1
sample_78,B,,basic,7129,6170,13299,0
sample_79,D,D,basic,7550,6916,14466,1
sample_80,C,C,basic,8199,6545,14744,1
sample_81,B,B,basic,6662,5930,12592,1
sample_82,B,D,basic,7950,11003,18953,0
sample_83,C,C,basic,6915,5802,12717,1
sample_84,B,B,basic,6773,4806,11579,1
sample_85,D,D,intermediate,37409,8564,45973,1
sample_86,C,C,basic,7356,5919,13275,1
sample_87,C,C,basic,7454,6892,14346,1
sample_88,D,D,basic,9003,6563,15566,1
sample_89,C,C,advanced,14692,9104,23796,1
sample_90,C,C,basic,7838,6546,14384,1
sample_91,E,E,advanced,18747,12137,30884,1
sample_92,B,,advanced,15033,10730,25763,0
sample_93,D,D,basic,6216,5271,11487,1
sample_94,E,C,advanced,19598,11846,31444,0
sample_95,C,C,basic,9083,10191,19274,1
sample_96,D,D,basic,11212,10378,21590,1
sample_97,A,A,basic,8433,7536,15969,1
sample_98,B,B,basic,8010,7878,15888,1
sample_99,C,C,basic,8088,7317,15405,1
sample_100,C,C,basic,6566,5717,12283,1
sample_101,E,E,basic,9127,8186,17313,1
sample_102,A,A,basic,6155,5312,11467,1
sample_103,A,A,basic,7303,6459,13762,1
sample_104,A,A,advanced,16145,11678,27823,1
sample_105,C,C,basic,6330,4857,11187,1
sample_106,B,B,basic,8199,6867,15066,1
sample_107,C,A,basic,6809,5370,12179,0
sample_108,A,A,basic,6341,5136,11477,1
sample_109,E,E,basic,7304,6351,13655,1
sample_110,C,C,basic,8573,6907,15480,1
sample_111,D,D,advanced,22461,12636,35097,1
sample_112,C,C,basic,8853,7372,16225,1
sample_113,B,A,advanced,16028,9792,25820,0
sample_114,D,D,basic,7739,6762,14501,1
sample_115,D,D,basic,7581,6172,13753,1
sample_116,E,E,basic,8792,7614,16406,1
sample_117,D,E,advanced,13632,8430,22062,0
sample_118,D,D,basic,7675,5817,13492,1
sample_119,E,E,basic,8088,6695,14783,1
sample_120,C,C,advanced,15722,9730,25452,1
sample_121,D,B,basic,8472,7218,15690,0
sample_122,B,B,basic,7444,5547,12991,1
sample_123,E,E,basic,6589,5500,12089,1
sample_124,A,A,advanced,19720,11675,31395,1
sample_125,B,B,basic,6606,5645,12251,1
sample_126,A,A,basic,6828,5535,12363,1
sample_127,A,A,advanced,14924,9371,24295,1
sample_128,D,D,advanced,21583,14105,35688,1
sample_129,A,C,advanced,18726,11922,30648,0
sample_130,A,A,basic,6898,5533,12431,1
sample_131,B,B,basic,8854,7647,16501,1
sample_132,B,B,basic,7930,7057,14987,1
sample_133,A,A,intermediate,32841,8660,41501,1
sample_134,B,B,advanced,19331,12075,31406,1
sample_135,A,A,basic,6474,5362,11836,1
sample_136,C,C,basic,6710,7127,13837,1
sample_137,D,D,basic,7245,7635,14880,1
sample_138,E,E,advanced,21282,14006,35288,1
sample_139,C,C,basic,6420,5603,12023,1
sample_140,D,D,basic,8759,7867,16626,1
sample_141,D,D,basic,5983,4810,10793,1
sample_142,A,A,basic,7992,5844,13836,1
sample_143,A,A,basic,6944,6200,13144,1
sample_144,B,B,basic,7312,6416,13728,1
sample_145,D,A,basic,6148,4782,10930,0
sample_146,D,C,basic,7459,5963,13422,0
sample_147,D,D,basic,6626,5429,12055,1
sample_148,D,D,basic,7181,5772,12953,1
sample_149,B,B,advanced,15723,10429,26152,1
sample_150,E,A,basic,6118,4545,10663,0
sample_151,A,A,basic,9951,8130,18081,1
sample_152,E,E,advanced,3274,2846,6120,1
sample_153,A,A,basic,7285,6105,13390,1
sample_154,A,A,basic,8910,7406,16316,1
sample_155,D,D,basic,7990,6610,14600,1
sample_156,E,E,basic,7608,6295,13903,1
sample_157,B,B,basic,9155,7627,16782,1
sample_158,A,A,basic,5620,4868,10488,1
sample_159,D,D,advanced,19285,11053,30338,1
sample_160,C,C,basic,8328,7441,15769,1
sample_161,D,D,basic,8543,7261,15804,1
sample_162,B,B,intermediate,35856,9363,45219,1
sample_163,D,D,advanced,15296,9980,25276,1
sample_164,A,A,advanced,14903,9798,24701,1
sample_165,A,A,basic,7364,5896,13260,1
sample_166,B,B,basic,8671,7705,16376,1
sample_167,B,B,basic,10908,9650,20558,1
sample_168,D,D,advanced,18093,10874,28967,1
sample_169,B,C,advanced,15741,10218,25959,0
sample_170,D,D,basic,6984,6173,13157,1
sample_171,C,C,basic,7359,6766,14125,1
sample_172,D,D,basic,6473,5227,11700,1
sample_173,C,C,basic,7726,6653,14379,1
sample_174,A,B,basic,6675,6155,12830,0
sample_175,E,E,basic,8370,7101,15471,1
sample_176,D,D,advanced,19425,13056,32481,1
sample_177,E,E,basic,5827,4374,10201,1
sample_178,D,D,intermediate,30689,7336,38025,1
sample_179,D,D,basic,10197,9093,19290,1
sample_180,D,D,basic,8170,7665,15835,1
sample_181,B,D,advanced,21212,12655,33867,0
sample_182,E,E,basic,6050,4963,11013,1
sample_183,B,B,basic,7801,6281,14082,1
sample_184,E,C,basic,6941,5797,12738,0
sample_185,B,B,basic,7425,5995,13420,1
sample_186,D,D,basic,6742,5229,11971,1
sample_187,C,,basic,8250,7954,16204,0
sample_188,B,B,intermediate,27515,7022,34537,1
sample_189,E,E,basic,8804,7224,16028,1
sample_190,C,C,basic,6585,5618,12203,1
sample_191,A,A,intermediate,27641,6404,34045,1
sample_192,D,D,advanced,17232,11807,29039,1
sample_193,E,E,basic,6237,4750,10987,1
sample_194,C,C,basic,6182,5323,11505,1
sample_195,C,C,basic,6477,5532,12009,1
sample_196,C,C,basic,7896,7185,15081,1
sample_197,A,A,basic,7457,6568,14025,1
sample_198,C,C,basic,7540,6097,13637,1
sample_199,E,C,basic,5718,6782,12500,0
sample_200,D,D,basic,6987,6146,13133,1
sample_201,B,B,basic,10411,9331,19742,1
sample_202,B,B,basic,6853,5942,12795,1
sample_203,D,C,basic,6186,5156,11342,0
sample_204,A,C,advanced,15423,11126,26549,0
sample_205,C,C,basic,7143,6270,13413,1
sample_206,B,B,basic,8466,6761,15227,1
sample_207,D,D,basic,7309,6280,13589,1
sample_208,A,,basic,6440,5166,11606,0
sample_209,B,B,basic,7293,7551,14844,1
sample_210,A,A,basic,6502,5349,11851,1
sample_211,C,C,basic,7516,6294,13810,1
sample_212,B,D,advanced,19198,11765,30963,0
sample_213,E,A,basic,10383,8543,18926,0
sample_214,A,A,basic,7023,5702,12725,1
sample_215,B,B,basic,7181,6526,13707,1
sample_216,D,D,basic,8420,7495,15915,1
sample_217,E,E,basic,9943,8638,18581,1
sample_218,D,D,basic,8263,6935,15198,1
sample_219,E,E,basic,6256,5266,11522,1
sample_220,A,A,advanced,15152,9363,24515,1
sample_221,D,D,basic,12364,10636,23000,1
sample_222,A,A,basic,6866,5707,12573,1
sample_223,D,C,basic,9254,8254,17508,0
sample_224,A,A,basic,8871,8046,16917,1
sample_225,C,C,basic,6307,5340,11647,1
sample_226,C,C,basic,7141,6403,13544,1
sample_227,D,D,basic,7153,5419,12572,1
sample_228,D,D,basic,8306,7175,15481,1
sample_229,A,B,basic,9904,7283,17187,0
sample_230,E,E,basic,7986,5902,13888,1
sample_231,C,C,basic,6910,6086,12996,1
sample_232,A,A,basic,7559,6273,13832,1
sample_233,D,D,advanced,13911,8998,22909,1
sample_234,B,B,basic,9999,9602,19601,1
sample_235,D,D,basic,7797,7380,15177,1
sample_236,B,B,basic,5362,4187,9549,1
sample_237,A,A,basic,7497,6937,14434,1
sample_238,B,E,basic,6168,4701,10869,0
sample_239,B,,basic,7936,12294,20230,0
sample_240,A,D,basic,7310,5927,13237,0
sample_241,E,E,basic,7030,5271,12301,1
sample_242,B,A,basic,7601,5704,13305,0
sample_243,A,A,basic,7849,6172,14021,1
sample_244,A,C,basic,13887,13036,26923,0
sample_245,E,E,basic,6583,6002,12585,1
sample_246,D,A,basic,7069,5185,12254,0
sample_247,A,B,basic,9159,7651,16810,0
sample_248,D,D,basic,9212,8243,17455,1
sample_249,C,D,intermediate,66623,9202,75825,0
sample_250,B,B,basic,6877,5456,12333,1
sample_251,A,D,advanced,13274,8610,21884,0
sample_252,B,B,basic,5786,4994,10780,1
sample_253,A,A,basic,6978,5612,12590,1
sample_254,D,D,basic,9634,8690,18324,1
sample_255,A,A,basic,11401,10331,21732,1
sample_256,C,C,basic,7371,6614,13985,1
sample_257,D,D,basic,7436,6291,13727,1
sample_258,D,D,basic,7227,6411,13638,1
sample_259,E,E,basic,8780,7631,16411,1
sample_260,D,D,basic,7338,5906,13244,1
sample_261,C,C,basic,9159,7468,16627,1
sample_262,C,C,basic,6928,5611,12539,1
sample_263,E,B,advanced,19467,12876,32343,0
sample_264,C,C,basic,8074,7310,15384,1
sample_265,A,A,advanced,21350,12014,33364,1
sample_266,E,A,advanced,18065,12399,30464,0
sample_267,B,D,basic,7260,5549,12809,0
sample_268,E,E,basic,5590,4636,10226,1
sample_269,E,E,basic,5966,4357,10323,1
sample_270,D,D,advanced,14003,9105,23108,1
sample_271,C,C,advanced,12037,7819,19856,1
sample_272,B,D,basic,7243,5323,12566,0
sample_273,C,C,basic,6713,5981,12694,1
sample_274,A,D,intermediate,269320,76920,346240,0
sample_275,A,A,basic,7556,6232,13788,1
sample_276,A,A,basic,7134,5817,12951,1
sample_277,C,C,basic,9201,7127,16328,1
sample_278,D,D,basic,5730,4885,10615,1
sample_279,A,D,advanced,16326,9957,26283,0
sample_280,B,B,basic,7504,6093,13597,1
sample_281,B,B,basic,7825,6197,14022,1
sample_282,D,D,basic,5877,5365,11242,1
sample_283,A,A,basic,6448,5266,11714,1
sample_284,A,A,basic,10703,9137,19840,1
sample_285,B,D,basic,7811,6289,14100,0
sample_286,D,A,basic,7427,6546,13973,0
sample_287,D,D,basic,6157,5619,11776,1
sample_288,A,A,basic,9618,7469,17087,1
sample_289,B,B,basic,9413,8776,18189,1
sample_290,D,D,advanced,20477,14553,35030,1
sample_291,B,A,basic,6780,5300,12080,0
sample_292,A,A,basic,8046,7685,15731,1
sample_293,D,D,basic,7578,6414,13992,1
sample_294,A,A,advanced,16500,10129,26629,1
sample_295,A,A,basic,6874,5971,12845,1
sample_296,B,B,basic,6095,5057,11152,1
sample_297,A,A,basic,5748,4550,10298,1
sample_298,D,D,basic,10740,9218,19958,1
sample_299,E,E,basic,6198,4961,11159,1
sample_300,B,B,basic,6415,5561,11976,1
sample_301,D,D,basic,5728,4729,10457,1
sample_302,D,D,basic,6079,5172,11251,1
sample_303,A,A,basic,6791,5351,12142,1
sample_304,D,A,advanced,17861,10197,28058,0
sample_305,A,A,advanced,16113,10106,26219,1
sample_306,B,B,advanced,17533,11167,28700,1
sample_307,C,C,basic,8601,7021,15622,1
sample_308,C,B,advanced,16052,10401,26453,0
sample_309,C,C,basic,6604,6179,12783,1
sample_310,D,D,basic,9522,7556,17078,1
sample_311,B,A,basic,6850,5753,12603,0
sample_312,D,D,basic,7403,6436,13839,1
sample_313,B,E,advanced,16197,11045,27242,0
sample_314,B,B,basic,8428,6818,15246,1
sample_315,A,B,basic,8446,7306,15752,0
sample_316,B,B,advanced,18333,11084,29417,1
sample_317,A,A,basic,6214,5091,11305,1
sample_318,B,,basic,6052,5365,11417,0
sample_319,C,C,basic,9183,8401,17584,1
sample_320,B,A,basic,9097,7910,17007,0
sample_321,D,B,advanced,17699,11649,29348,0
sample_322,A,D,basic,7571,6266,13837,0
sample_323,D,D,advanced,19734,12749,32483,1
sample_324,C,C,advanced,13743,8642,22385,1
sample_325,A,A,basic,7398,5261,12659,1
sample_326,C,C,basic,7286,6709,13995,1
sample_327,B,B,basic,6420,5360,11780,1
sample_328,A,A,basic,6265,5726,11991,1
sample_329,B,B,basic,6776,5342,12118,1
sample_330,B,A,basic,7507,5532,13039,0
sample_331,C,D,advanced,16838,11970,28808,0
